land purcharse - zakup ziemi
approval - zatwierdzenie
surveyor - geodeta
geological survey - badanie geodezyjne
feasibility study - badanie wykonalnoœci
excavation - wykopaliska
get the back on track - powróciæ rzeczy na w³aœciwy tor
bog down - zapl¹taæ w czymœ
red tape == bureaucracy
slippage - poœlizg
cost overruns - przekraczanie kosztów
foundations - fundamenty
dam - tama
resettlement - przesiedlenie
river diversion - przekierowanie rzeki
scope - zakres
retreats - odizolowaæ siê
touchy-feely - tkliwe
blindfold - opaska na oczy
rope courses - park linowy
labelled - zaszufladkowane
mediocre - œredni
sincere - szczery
merge - po³¹czyæ
key lessons - kluczowe lekcje
commitment - zaanga¿owanie
goal - cel
accomplish - osi¹gn¹æ
bunch of (people, flowers) - grupa ludzi/bukiet kwiatów
everyone buys into - ka¿dy przystaje
shortcommings - niedoci¹gniêcia
endured - wytrzymaæ
accountable - odpowiedzialny
impose - narzucaæ
lost temper == angry
prevail - zwyciê¿a
there's no getting around it == can't avoid it
start from scratch - zacz¹æ od pocz¹tku
loner - samotnik
the maverick - indywidualista
anxious - niespokojny
single-minded - zdeterminowany
burning out - wypaliæ siê
settling in - wdra¿aæ 
stakeholders - interesariusze
accustomed - przyzwyczajony
deserted - opuszczone
forecourt - obs³uga klienta
sit back - siedzieæ i nic nie robiæ
ensure - upewniæ
mess - ba³agan
hierarchical - hierarchiczny
kid gloves == very kind
sort it out - rozwi¹zaæ
forecourt staff - obs³uga klienta
behind shedule == late
crucial - bardzo wa¿ne
work your finger to the bone == very hard
hand in - wrêczyæ
interfere - wtr¹caæ siê

