elusive - ulotny
durability - wytrzyma³oœæ
superficial - powierzchowny
reliability - niezawodnoœæ
enchanting - uroczy, czaruj¹cy
lifespan - d³. ¿ycia
craze - sza³ 
sour - kwaœny(tu: w sensie psuje atmosferê)
marvel - cud
spare parts - czêœci zamienne
obsolescence - postarzanie
flaws - wady
shrink - kurczyæ siê
struggle - zmagaæ siê
burst of progress - du¿y postêp
intrinsically - ze swej istoty
--reowned - s³ynny
entrepreneur - przedsiêbiorca
price of admission - cena za wstêp
fads - trendy
cease - stop
commitment - zaanga¿owanie
rumble - huk
--rattling - turkotliwy, grzechotaæ
chattering - rozmawiaæ
splash out on sth. - wydaæ du¿o na g³upoty
resources - œrodki
constantly - ci¹gle/stalec
concern - zmartwiæ
exacting - doprecyzowanie
cracked - pêkniêty
disposable - jednorazowy
flawed - wadliwy
flimsy - lichy
fragile - kruchy
heavy-duty - solidny
reliable - niezawodny
scratched - zarysowany
shoddy - tandeta
tough - twardy
statutory requirements - wymagania ustawowe
established - ustanowiony
faded - wyblak³e
night shift - nacna zmiana
racks - rega³y
patch - p³at
batch - partia(towaru)
mutual - wzajemny
stain - plama
teething problems - ma³e problemy pocz¹tkuj¹cej firmy
nuisance - k³opot, przykroœæ
vial - fiolka
forklift - wózek wid³owy
ripe - dojrza³y
refrigerated display cases - lodówki sklepowe
allied with - sprzymierzony
unrivalled - niezrównany
trays - tace
punnets - kobia³ki
---shrivelled - marszczyæ siê
decay - gniæ
-----incentive - zachêta
shallow - p³ytki
squash - zmia¿dzyæ
nitrogen fertilization - nawo¿enie azotem
bruise - siniak
bulk - ogrom
-----
feasibility study - badanie wykonalnoœci
excavation - wykopaliska
dam - tama
resettlement - przesiedlenie
river diversion - przekierownie rzeki
accomplish - ukoñczyæ
bunch - grono
offend - obraziæ
scope - zakres
surveyor - geodeta
prevailed - zwyciê¿y³



